00000000000000000000000000000
00000000000000000000000000000
00000000000000000000000000000
00000100000000000100000000000
00000200100000010200100000100
01110201200101020201210111210
12201212211212121212221222221
20232202222222222222202222222
22202202023232202022222222202
02023232032323320022222222202
02030232322230222032232223202
02020222322220222223022222222
22220222222222222222302232223
44444444444444444444444444444
