00000000000000000000000000000
00000000000000000000000000000
00000000000000000000000000000
00000100000000100000000000000
00000200000001200000000110100
00100200111102201111001220211
11211211222212212222112221202
22222220002222222222222222232
22223220222230022202222022202
02322233222222030202032022223
03022223232232020202203322232
02022222222222220322202322022
22232222203222222222202222322
44444444444444444444444444444
