0000000000000000000000000000000000000000000000000000
0000000000000000000000000000000000000000000000000000
0000000000000000000000000000000000000000000000000000
0000000000000000000000000000000000000000000000000000
0000000000000000000000000000000000000000000000000000
0000000000000000000000000000000000000000000000000000
0000000000000000000000000000000000000000000000000000
0000000000000000000000000000000000000000000000000000
0000000000000000000000000000000000000000000000000000
0000000000000000000000000000000000000000000000000000
0001111111011111111111111111111111111111111111111111
1111111111011111111111111111111111111111111111111111
1111111111011111111111111111111111111111111111111111
1111111111011111111111111111111111111111111111111111
1111111111011111111111111111111111111111111111111111
1111111110000000000111111111111111111111111111111111
1111000000000000111111111111111111111111111111111111
1111100000000000011111111111111111111111111111111111
1110000000000000000001111111111111111111111111111111
1111111111111111111111111111111111111111111111111111
1111111111111111111111111111111111111111111111111111
