2000000000000000000000
0200000000000000000000
0020000000000000000000
0002000000000000000000
0000200000000000000000
0000020000000000000000
1111111111111111111111
2222222222222222222222
2222222222222222222222
2222222222222222222222
2222233333333332222222
2222222222222222222222
2222222222222222222222
2222222222222222222222


