00000000000000000000000000000
00000000000000000000000000000
00000000000000000000000000000
00000000000000100000000000010
01011000000100200000000000020
12022010011200211100110011021
22122101122211222211221122122
22222232222222222220202220222
22202202322022222220222302202
22302023202203223223322202202
32232032302220222223033202202
22230022202220222322022222222
22223222223220222222202222322
44444444444444444444444444444
