00000000000000000000000000000
00000000000000000000000000000
00000000000000000000000000000
00010000000000000010000000000
00020010010000000020000000110
10121120120011010120000011221
21220221221122121221111122222
22023220222222222222222222220
22200200222322202222322222202
03202223222222302322203023202
00203223222332202223222020233
00222222202222222222222030232
20222322232222223222222222220
44444444444444444444444444444
