00000000000000000000000000000
00000000000000000000000000000
00000000000000000000000000000
00000001000100000000000000000
00010002101200000000000000001
10020002202201111111011110002
21121112212212222202122221112
22222222222222202230222220222
22322222022022222202222200320
23223232222003022322222203200
20322322222022022033222303203
20222222220222022022223222203
20222222233222222220232222222
44444444444444444444444444444
