00000000000000000000000000000
00000000000000000000000000000
00000000000000000000000000000
00000100000000000100000000000
00001200000100000210010000000
10012200110201101220121101001
21122211021212212221222212112
02222222322222222220222220222
22220232023220222000222222222
23330220232200222023022222322
22203232322200222023023223032
22203222222002222222022222023
22222222222322233222222220022
44444444444444444444444444444
