00000000000000000000000000000
00000000000000000000000000000
00000000000000000000000000000
00000100000000001000000000000
00001200000000112000000001000
11012210010101222010001012101
22122221121212222121110122212
02222222022022222222223222222
22220023022232202222220222022
23222022323223202220232302002
32222022320230232230323202022
22232222220220032220222202222
02222222230222322322222222222
44444444444444444444444444444
