00000000000000000000000000000
00000000000000000000000000000
00000000000000000000000000000
00000000001001000000000000000
00010000002002000000100010010
01120100012102101111210020120
12021211122212212222221121221
00322222222222222022222222222
02023222320022222222022222202
32222200220032233222232223002
33322220320022200232223222032
22222220222222200223222202032
20222222222222302222222332222
44444444444444444444444444444
