00000000000000000000000000000
00000000000000000000000000000
00000000000000000000000000000
00000001000000000000010000000
00100002101000000000020000100
00211112212010000110021101201
11222222222121111221122012212
02222202202222222222222322222
02222220022223223022222022022
30230220222222232033322222002
30200320232222203022222332322
20000222222222202222223222322
22322222202232302222222222222
44444444444444444444444444444
