00000000000000000000000000000
00000000000000000000000000000
00000000000000000000000000000
00000000100001000000000000000
00001000200102000100000000100
01112110210212001210110000210
12202221221222112221221111221
22232220222202222222222222202
22202220022222222023022223022
03222203020222332232022322022
02232203022232222203032032322
02320202222222222202222022322
22223222232202222222223022222
44444444444444444444444444444
