00000000000000000000000000000
00000000000000000000000000000
00000000000000000000000000000
00000000010000000000000000100
10000000020000100100000100200
21000010021111210201001210211
22111121122222221212112221202
22222222222002222222202222232
02222322222222222020302222002
02030203222222222230233222023
32200202322322232220330222032
32200202222223222222220022222
22202222223022222222222323222
44444444444444444444444444444
