00000000000000000000000000000
00000000000000000000000000000
00000000000000000000000000000
00000010000000000000010000000
10000020000100000100020100000
21101120100210100210121210010
22210221211221211221222221121
20223222220222222222220222222
02020222220023223222202222222
02022322203222032223202230223
32023022203222003222303222322
32222022202222002022222222232
22232222222232202322220222222
44444444444444444444444444444
