000000000000000000000000000
000000000000000000000000000
000000000000000000000000000
000000000000000000000000000
000000000000000000000000000
000000000000000000000000000
111111111111111111111111111
222222220000000000022222222
222222220000000000022222222
222222220000000000022222222
222222220000000000022222222
222222220000000000022222222
222222222222222222222222222
