200000000000000000000000000
020000000000000000000000000
002000000000000000000000000
000200000000000000000000000
000020000000000000000000000
000002000000000000000000000
111111111111111111111111111
222222222222222222222222222
222222222222222222222222222
222222222222333333222222222
222222222222333322222222222
222222222222222222222222222
222222222222222222222222222
444444444444444444444444444
