00000000000000000000000000000
00000000000000000000000000000
00000000000000000000000000000
00010000000000000000000000100
01020000011000000000000000210
12021100122011010011000011221
22122211222120121122111122222
22222022222023222220222222222
22302222202020222222232202202
22202223302332323202220002222
22303330232303222202222002222
20222220232202222202222022223
23222020222222232222322222222
44444444444444444444444444444
