000000000000000000000000000
000000000000000000000000000
000000000000000000000000000
000000000100000000000000000
000000001210000000011000100
101100012221000001122000210
212211122222111112222111221
222222222222222222222222222
222222222223322222222222222
233322222222333333222333222
222223333222333322222333322
333333333333333333333333333
333333333333333333333333333
444444444444444444444444444





