200000000000000000000000000
020000000000000000000000000
002000000000000000000000000
000200000000000000000000000
000020000000000000000000000
000002000000000000000000000
222222222222222222222222222
222222222222222222222222222
222222222222222222222222222
222222222222222222222222222
222222222222222222222222222
222222222222222222222222222
222222222222222222222222222
