00000000000000000000000000000
00000000000000000000000000000
00000000000000000000000000000
00000000000000000100010000000
00000100000000000200021010010
00011200011111010211022021120
11122211122222121222122120221
22020222222202222222222223222
22022023222222322222202220002
23322022222320220232302022023
22332332222230320202002223022
22222322222220230202020222222
22222222322202222223023222222
44444444444444444444444444444
