00000000000000000000000000000
00000000000000000000000000000
00000000000000000000000000000
00000000001000100000000000000
00001000002001200000001000010
01002101102012201101112100021
12112212212122212212222011122
22222222222222200222202322222
22320022230222202222220022222
00230023220232232222222203322
00223022330302233222222320222
00223222222202222222322220202
22222232222222220222222220233
44444444444444444444444444444
